"filename", "language", "JavaScript", "JSON", "CSS", "Markdown", "HTML", "comment", "blank", "total"
"/home/sumerau/Documents/inventory-app-front-end/src/components/ContentBuilder.js", "JavaScript", 191, 0, 0, 0, 0, 5, 10, 206
"/home/sumerau/Documents/inventory-app-front-end/src/components/ContentList.js", "JavaScript", 185, 0, 0, 0, 0, 8, 20, 213
"/home/sumerau/Documents/inventory-app-front-end/src/components/contentPresets.js", "JavaScript", 126, 0, 0, 0, 0, 2, 6, 134
"/home/sumerau/Documents/inventory-app-front-end/src/components/controls/ItemEditControls.js", "JavaScript", 75, 0, 0, 0, 0, 3, 9, 87
"/home/sumerau/Documents/inventory-app-front-end/src/components/controls/SignItemInOutControls.js", "JavaScript", 74, 0, 0, 0, 0, 3, 9, 86
"/home/sumerau/Documents/inventory-app-front-end/src/components/controls/UserEditControls.js", "JavaScript", 92, 0, 0, 0, 0, 3, 10, 105
"/home/sumerau/Documents/inventory-app-front-end/src/components/controls/index.js", "JavaScript", 8, 0, 0, 0, 0, 3, 1, 12
"/home/sumerau/Documents/inventory-app-front-end/src/components/inputValidation/HandleOnChangeEvent.js", "JavaScript", 175, 0, 0, 0, 0, 32, 16, 223
"/home/sumerau/Documents/inventory-app-front-end/src/components/inputValidation/ItemValidation.js", "JavaScript", 101, 0, 0, 0, 0, 10, 29, 140
"/home/sumerau/Documents/inventory-app-front-end/src/components/inputValidation/SanitizeData.js", "JavaScript", 30, 0, 0, 0, 0, 8, 10, 48
"/home/sumerau/Documents/inventory-app-front-end/src/components/inputValidation/UserValidation.js", "JavaScript", 95, 0, 0, 0, 0, 1, 27, 123
"/home/sumerau/Documents/inventory-app-front-end/src/components/inputValidation/index.js", "JavaScript", 10, 0, 0, 0, 0, 3, 1, 14
"/home/sumerau/Documents/inventory-app-front-end/src/components/itemModals/AddItemModal.js", "JavaScript", 277, 0, 0, 0, 0, 9, 22, 308
"/home/sumerau/Documents/inventory-app-front-end/src/components/itemModals/DeleteItemModal.js", "JavaScript", 90, 0, 0, 0, 0, 7, 16, 113
"/home/sumerau/Documents/inventory-app-front-end/src/components/itemModals/EditItemModal.js", "JavaScript", 303, 0, 0, 0, 0, 9, 22, 334
"/home/sumerau/Documents/inventory-app-front-end/src/components/itemModals/SignItemInModal.js", "JavaScript", 137, 0, 0, 0, 0, 9, 16, 162
"/home/sumerau/Documents/inventory-app-front-end/src/components/itemModals/SignItemOutModal.js", "JavaScript", 196, 0, 0, 0, 0, 14, 24, 234
"/home/sumerau/Documents/inventory-app-front-end/src/components/itemModals/index.js", "JavaScript", 12, 0, 0, 0, 0, 3, 1, 16
"/home/sumerau/Documents/inventory-app-front-end/src/components/logModals/AdminLogModal.js", "JavaScript", 106, 0, 0, 0, 0, 5, 15, 126
"/home/sumerau/Documents/inventory-app-front-end/src/components/logModals/ApproveUsersModal.js", "JavaScript", 167, 0, 0, 0, 0, 2, 19, 188
"/home/sumerau/Documents/inventory-app-front-end/src/components/logModals/ItemLogModal.js", "JavaScript", 105, 0, 0, 0, 0, 5, 13, 123
"/home/sumerau/Documents/inventory-app-front-end/src/components/logModals/ViewNotesModal.js", "JavaScript", 105, 0, 0, 0, 0, 0, 7, 112
"/home/sumerau/Documents/inventory-app-front-end/src/components/logModals/index.js", "JavaScript", 10, 0, 0, 0, 0, 0, 1, 11
"/home/sumerau/Documents/inventory-app-front-end/src/components/profileModals/LoginModal.js", "JavaScript", 141, 0, 0, 0, 0, 8, 13, 162
"/home/sumerau/Documents/inventory-app-front-end/src/components/profileModals/LogoutModal.js", "JavaScript", 61, 0, 0, 0, 0, 4, 9, 74
"/home/sumerau/Documents/inventory-app-front-end/src/components/profileModals/index.js", "JavaScript", 6, 0, 0, 0, 0, 0, 1, 7
"/home/sumerau/Documents/inventory-app-front-end/src/components/tableStuff/Table.js", "JavaScript", 79, 0, 0, 0, 0, 0, 6, 85
"/home/sumerau/Documents/inventory-app-front-end/src/components/tableStuff/TableNav.js", "JavaScript", 27, 0, 0, 0, 0, 0, 2, 29
"/home/sumerau/Documents/inventory-app-front-end/src/components/tableStuff/index.js", "JavaScript", 6, 0, 0, 0, 0, 0, 1, 7
"/home/sumerau/Documents/inventory-app-front-end/src/components/userModals/AddUserModal.js", "JavaScript", 333, 0, 0, 0, 0, 13, 36, 382
"/home/sumerau/Documents/inventory-app-front-end/src/components/userModals/DeleteUserModal.js", "JavaScript", 105, 0, 0, 0, 0, 7, 16, 128
"/home/sumerau/Documents/inventory-app-front-end/src/components/userModals/EditUserModal.js", "JavaScript", 352, 0, 0, 0, 0, 22, 28, 402
"/home/sumerau/Documents/inventory-app-front-end/src/components/userModals/index.js", "JavaScript", 8, 0, 0, 0, 0, 3, 1, 12
"/home/sumerau/Documents/inventory-app-front-end/src/components/utilities/MapNotes.js", "JavaScript", 24, 0, 0, 0, 0, 0, 0, 24
"/home/sumerau/Documents/inventory-app-front-end/src/components/utilities/ToggleSwitch.js", "JavaScript", 21, 0, 0, 0, 0, 0, 4, 25
"c:/Users/Will/inventory-app-front-end/README.md", "Markdown", 0, 0, 0, -38, 0, 0, -33, -71
"c:/Users/Will/inventory-app-front-end/package-lock.json", "JSON", 0, -16118, 0, 0, 0, 0, -1, -16119
"c:/Users/Will/inventory-app-front-end/package.json", "JSON", 0, -49, 0, 0, 0, 0, -1, -50
"c:/Users/Will/inventory-app-front-end/public/index.html", "HTML", 0, 0, 0, 0, -20, -23, -1, -44
"c:/Users/Will/inventory-app-front-end/public/manifest.json", "JSON", 0, -25, 0, 0, 0, 0, -1, -26
"c:/Users/Will/inventory-app-front-end/src/App.js", "JavaScript", -14, 0, 0, 0, 0, 0, -3, -17
"c:/Users/Will/inventory-app-front-end/src/ErrorBoundary.js", "JavaScript", -30, 0, 0, 0, 0, -5, -6, -41
"c:/Users/Will/inventory-app-front-end/src/components/ContentBuilder.js", "JavaScript", -139, 0, 0, 0, 0, -3, -14, -156
"c:/Users/Will/inventory-app-front-end/src/components/ContentList.js", "JavaScript", -189, 0, 0, 0, 0, -7, -19, -215
"c:/Users/Will/inventory-app-front-end/src/components/ContentPresets.js", "JavaScript", -129, 0, 0, 0, 0, -2, -6, -137
"c:/Users/Will/inventory-app-front-end/src/components/Controls/ItemEditControls.js", "JavaScript", -68, 0, 0, 0, 0, -3, -8, -79
"c:/Users/Will/inventory-app-front-end/src/components/Controls/SignItemInOutControls.js", "JavaScript", -61, 0, 0, 0, 0, -3, -7, -71
"c:/Users/Will/inventory-app-front-end/src/components/Controls/UserEditControls.js", "JavaScript", -84, 0, 0, 0, 0, -3, -10, -97
"c:/Users/Will/inventory-app-front-end/src/components/InputValidation/itemValidation.js", "JavaScript", -77, 0, 0, 0, 0, -10, -16, -103
"c:/Users/Will/inventory-app-front-end/src/components/InputValidation/sanitizeData.js", "JavaScript", -32, 0, 0, 0, 0, -8, -11, -51
"c:/Users/Will/inventory-app-front-end/src/components/InputValidation/userValidation.js", "JavaScript", -72, 0, 0, 0, 0, -1, -9, -82
"c:/Users/Will/inventory-app-front-end/src/components/ItemModals/AddItemModal.js", "JavaScript", -281, 0, 0, 0, 0, -25, -30, -336
"c:/Users/Will/inventory-app-front-end/src/components/ItemModals/DeleteItemModal.js", "JavaScript", -90, 0, 0, 0, 0, -6, -11, -107
"c:/Users/Will/inventory-app-front-end/src/components/ItemModals/EditItemModal.js", "JavaScript", -292, 0, 0, 0, 0, -25, -28, -345
"c:/Users/Will/inventory-app-front-end/src/components/ItemModals/SignItemInModal.js", "JavaScript", -88, 0, 0, 0, 0, -8, -11, -107
"c:/Users/Will/inventory-app-front-end/src/components/ItemModals/SignItemOutModal.js", "JavaScript", -139, 0, 0, 0, 0, -13, -16, -168
"c:/Users/Will/inventory-app-front-end/src/components/ItemModals/index.js", "JavaScript", -12, 0, 0, 0, 0, -3, -1, -16
"c:/Users/Will/inventory-app-front-end/src/components/LogModals/AdminLogModal.js", "JavaScript", -60, 0, 0, 0, 0, -3, -7, -70
"c:/Users/Will/inventory-app-front-end/src/components/LogModals/ItemLogModal.js", "JavaScript", -60, 0, 0, 0, 0, -4, -7, -71
"c:/Users/Will/inventory-app-front-end/src/components/ProfileModals/LoginModal.js", "JavaScript", -72, 0, 0, 0, 0, -3, -5, -80
"c:/Users/Will/inventory-app-front-end/src/components/ProfileModals/LogoutModal.js", "JavaScript", -37, 0, 0, 0, 0, -3, -5, -45
"c:/Users/Will/inventory-app-front-end/src/components/Table.js", "JavaScript", -72, 0, 0, 0, 0, 0, -4, -76
"c:/Users/Will/inventory-app-front-end/src/components/ToggleSwitch.js", "JavaScript", -20, 0, 0, 0, 0, 0, -3, -23
"c:/Users/Will/inventory-app-front-end/src/components/UserModals/AddUserModal.js", "JavaScript", -456, 0, 0, 0, 0, -30, -39, -525
"c:/Users/Will/inventory-app-front-end/src/components/UserModals/DeleteUserModal.js", "JavaScript", -98, 0, 0, 0, 0, -7, -13, -118
"c:/Users/Will/inventory-app-front-end/src/components/UserModals/EditUserModal.js", "JavaScript", -502, 0, 0, 0, 0, -38, -41, -581
"c:/Users/Will/inventory-app-front-end/src/components/UserModals/index.js", "JavaScript", -8, 0, 0, 0, 0, -3, -1, -12
"c:/Users/Will/inventory-app-front-end/src/controllers/AdminLogController.js", "JavaScript", -22, 0, 0, 0, 0, -9, -7, -38
"c:/Users/Will/inventory-app-front-end/src/controllers/AuthController.js", "JavaScript", -110, 0, 0, 0, 0, -31, -24, -165
"c:/Users/Will/inventory-app-front-end/src/controllers/GenericController.js", "JavaScript", -25, 0, 0, 0, 0, -21, -7, -53
"c:/Users/Will/inventory-app-front-end/src/controllers/ItemController.js", "JavaScript", -34, 0, 0, 0, 0, -16, -11, -61
"c:/Users/Will/inventory-app-front-end/src/controllers/ItemLogController.js", "JavaScript", -22, 0, 0, 0, 0, -9, -7, -38
"c:/Users/Will/inventory-app-front-end/src/controllers/LoginLogoutController.js", "JavaScript", -31, 0, 0, 0, 0, -5, -7, -43
"c:/Users/Will/inventory-app-front-end/src/controllers/UserController.js", "JavaScript", -53, 0, 0, 0, 0, -16, -15, -84
"c:/Users/Will/inventory-app-front-end/src/controllers/index.js", "JavaScript", -12, 0, 0, 0, 0, -2, -1, -15
"c:/Users/Will/inventory-app-front-end/src/index.js", "JavaScript", -14, 0, 0, 0, 0, -4, -2, -20
"c:/Users/Will/inventory-app-front-end/src/registerServiceWorker.js", "JavaScript", -79, 0, 0, 0, 0, -28, -11, -118
"c:/Users/Will/inventory-app-front-end/src/styles/App.css", "CSS", 0, 0, -96, 0, 0, -23, -19, -138
"c:/Users/Will/inventory-app-front-end/src/styles/ErrorBoundary.css", "CSS", 0, 0, -11, 0, 0, 0, -1, -12
"c:/Users/Will/inventory-app-front-end/src/styles/Modal.css", "CSS", 0, 0, -143, 0, 0, -19, -29, -191
"c:/Users/Will/inventory-app-front-end/src/styles/ToggleSwitch.css", "CSS", 0, 0, -73, 0, 0, -3, -5, -81
"c:/Users/Will/inventory-app-front-end/src/styles/table.css", "CSS", 0, 0, -135, 0, 0, -21, -27, -183
"Total", "-", 249, -16192, -458, -38, -20, -245, -120, -16824