"filename", "language", "JSON", "JavaScript", "Markdown", "HTML", "CSS", "comment", "blank", "total"
"/home/williamglass/inventory-app-front-end/.VSCodeCounter/2022-05-18_12-51-07/details.md", "Markdown", 0, 0, 56, 0, 0, 0, 6, 62
"/home/williamglass/inventory-app-front-end/.VSCodeCounter/2022-05-18_12-51-07/diff-details.md", "Markdown", 0, 0, 9, 0, 0, 0, 6, 15
"/home/williamglass/inventory-app-front-end/.VSCodeCounter/2022-05-18_12-51-07/diff.md", "Markdown", 0, 0, 12, 0, 0, 0, 7, 19
"/home/williamglass/inventory-app-front-end/.VSCodeCounter/2022-05-18_12-51-07/results.json", "JSON", 1, 0, 0, 0, 0, 0, 0, 1
"/home/williamglass/inventory-app-front-end/.VSCodeCounter/2022-05-18_12-51-07/results.md", "Markdown", 0, 0, 29, 0, 0, 0, 7, 36
"/home/williamglass/inventory-app-front-end/README.md", "Markdown", 0, 0, 38, 0, 0, 0, 33, 71
"/home/williamglass/inventory-app-front-end/package-lock.json", "JSON", 36118, 0, 0, 0, 0, 0, 1, 36119
"/home/williamglass/inventory-app-front-end/package.json", "JSON", 49, 0, 0, 0, 0, 0, 1, 50
"/home/williamglass/inventory-app-front-end/public/index.html", "HTML", 0, 0, 0, 20, 0, 23, 1, 44
"/home/williamglass/inventory-app-front-end/public/manifest.json", "JSON", 25, 0, 0, 0, 0, 0, 1, 26
"/home/williamglass/inventory-app-front-end/src/App.js", "JavaScript", 0, 12, 0, 0, 0, 0, 4, 16
"/home/williamglass/inventory-app-front-end/src/ErrorBoundary.js", "JavaScript", 0, 32, 0, 0, 0, 5, 5, 42
"/home/williamglass/inventory-app-front-end/src/components/ContentBuilder.js", "JavaScript", 0, 222, 0, 0, 0, 8, 18, 248
"/home/williamglass/inventory-app-front-end/src/components/ContentList.js", "JavaScript", 0, 205, 0, 0, 0, 9, 22, 236
"/home/williamglass/inventory-app-front-end/src/components/__test__/ContentBuilder.test.js", "JavaScript", 0, 18, 0, 0, 0, 5, 9, 32
"/home/williamglass/inventory-app-front-end/src/components/__test__/ContentList.test.js", "JavaScript", 0, 11, 0, 0, 0, 4, 4, 19
"/home/williamglass/inventory-app-front-end/src/components/__test__/controls/ItemEditControls.test.js", "JavaScript", 0, 52, 0, 0, 0, 3, 11, 66
"/home/williamglass/inventory-app-front-end/src/components/__test__/controls/SignItemInOutControls.test.js", "JavaScript", 0, 34, 0, 0, 0, 3, 10, 47
"/home/williamglass/inventory-app-front-end/src/components/__test__/controls/UserEditControls.test.js", "JavaScript", 0, 52, 0, 0, 0, 3, 11, 66
"/home/williamglass/inventory-app-front-end/src/components/contentPresets.js", "JavaScript", 0, 126, 0, 0, 0, 2, 6, 134
"/home/williamglass/inventory-app-front-end/src/components/controls/ItemEditControls.js", "JavaScript", 0, 102, 0, 0, 0, 3, 11, 116
"/home/williamglass/inventory-app-front-end/src/components/controls/SignItemInOutControls.js", "JavaScript", 0, 85, 0, 0, 0, 3, 10, 98
"/home/williamglass/inventory-app-front-end/src/components/controls/UserEditControls.js", "JavaScript", 0, 110, 0, 0, 0, 3, 12, 125
"/home/williamglass/inventory-app-front-end/src/components/controls/index.js", "JavaScript", 0, 8, 0, 0, 0, 3, 1, 12
"/home/williamglass/inventory-app-front-end/src/components/inputValidation/HandleOnChangeEvent.js", "JavaScript", 0, 256, 0, 0, 0, 39, 16, 311
"/home/williamglass/inventory-app-front-end/src/components/inputValidation/ItemValidation.js", "JavaScript", 0, 104, 0, 0, 0, 11, 26, 141
"/home/williamglass/inventory-app-front-end/src/components/inputValidation/SanitizeData.js", "JavaScript", 0, 26, 0, 0, 0, 6, 10, 42
"/home/williamglass/inventory-app-front-end/src/components/inputValidation/UserValidation.js", "JavaScript", 0, 85, 0, 0, 0, 1, 24, 110
"/home/williamglass/inventory-app-front-end/src/components/inputValidation/index.js", "JavaScript", 0, 10, 0, 0, 0, 3, 1, 14
"/home/williamglass/inventory-app-front-end/src/components/itemModals/AddItemModal.js", "JavaScript", 0, 278, 0, 0, 0, 8, 27, 313
"/home/williamglass/inventory-app-front-end/src/components/itemModals/DeleteItemModal.js", "JavaScript", 0, 94, 0, 0, 0, 7, 19, 120
"/home/williamglass/inventory-app-front-end/src/components/itemModals/EditItemModal.js", "JavaScript", 0, 368, 0, 0, 0, 11, 30, 409
"/home/williamglass/inventory-app-front-end/src/components/itemModals/SignItemInModal.js", "JavaScript", 0, 126, 0, 0, 0, 8, 19, 153
"/home/williamglass/inventory-app-front-end/src/components/itemModals/SignItemOutModal.js", "JavaScript", 0, 216, 0, 0, 0, 14, 26, 256
"/home/williamglass/inventory-app-front-end/src/components/itemModals/index.js", "JavaScript", 0, 12, 0, 0, 0, 3, 1, 16
"/home/williamglass/inventory-app-front-end/src/components/logModals/AdminLogModal.js", "JavaScript", 0, 109, 0, 0, 0, 5, 16, 130
"/home/williamglass/inventory-app-front-end/src/components/logModals/ApproveUsersModal.js", "JavaScript", 0, 178, 0, 0, 0, 2, 20, 200
"/home/williamglass/inventory-app-front-end/src/components/logModals/ItemLogModal.js", "JavaScript", 0, 104, 0, 0, 0, 5, 13, 122
"/home/williamglass/inventory-app-front-end/src/components/logModals/ViewNoteModal.js", "JavaScript", 0, 56, 0, 0, 0, 0, 8, 64
"/home/williamglass/inventory-app-front-end/src/components/logModals/index.js", "JavaScript", 0, 10, 0, 0, 0, 0, 1, 11
"/home/williamglass/inventory-app-front-end/src/components/profileModals/LoginModal.js", "JavaScript", 0, 154, 0, 0, 0, 8, 15, 177
"/home/williamglass/inventory-app-front-end/src/components/profileModals/LogoutModal.js", "JavaScript", 0, 65, 0, 0, 0, 4, 11, 80
"/home/williamglass/inventory-app-front-end/src/components/profileModals/index.js", "JavaScript", 0, 6, 0, 0, 0, 0, 1, 7
"/home/williamglass/inventory-app-front-end/src/components/tableStuff/Table.js", "JavaScript", 0, 142, 0, 0, 0, 0, 7, 149
"/home/williamglass/inventory-app-front-end/src/components/tableStuff/TableNav.js", "JavaScript", 0, 30, 0, 0, 0, 0, 2, 32
"/home/williamglass/inventory-app-front-end/src/components/tableStuff/index.js", "JavaScript", 0, 6, 0, 0, 0, 0, 1, 7
"/home/williamglass/inventory-app-front-end/src/components/userModals/AddUserModal.js", "JavaScript", 0, 352, 0, 0, 0, 12, 32, 396
"/home/williamglass/inventory-app-front-end/src/components/userModals/DeleteUserModal.js", "JavaScript", 0, 109, 0, 0, 0, 7, 18, 134
"/home/williamglass/inventory-app-front-end/src/components/userModals/EditUserModal.js", "JavaScript", 0, 424, 0, 0, 0, 22, 31, 477
"/home/williamglass/inventory-app-front-end/src/components/userModals/index.js", "JavaScript", 0, 8, 0, 0, 0, 3, 1, 12
"/home/williamglass/inventory-app-front-end/src/components/utilities/MapNotes.js", "JavaScript", 0, 24, 0, 0, 0, 0, 0, 24
"/home/williamglass/inventory-app-front-end/src/components/utilities/ToggleSwitch.js", "JavaScript", 0, 21, 0, 0, 0, 0, 4, 25
"/home/williamglass/inventory-app-front-end/src/controllers/AdminLogController.js", "JavaScript", 0, 22, 0, 0, 0, 9, 6, 37
"/home/williamglass/inventory-app-front-end/src/controllers/AuthController.js", "JavaScript", 0, 113, 0, 0, 0, 33, 23, 169
"/home/williamglass/inventory-app-front-end/src/controllers/GenericController.js", "JavaScript", 0, 25, 0, 0, 0, 7, 6, 38
"/home/williamglass/inventory-app-front-end/src/controllers/ItemController.js", "JavaScript", 0, 34, 0, 0, 0, 12, 10, 56
"/home/williamglass/inventory-app-front-end/src/controllers/ItemLogController.js", "JavaScript", 0, 22, 0, 0, 0, 9, 7, 38
"/home/williamglass/inventory-app-front-end/src/controllers/LoginLogoutController.js", "JavaScript", 0, 32, 0, 0, 0, 5, 8, 45
"/home/williamglass/inventory-app-front-end/src/controllers/UserController.js", "JavaScript", 0, 60, 0, 0, 0, 18, 15, 93
"/home/williamglass/inventory-app-front-end/src/controllers/index.js", "JavaScript", 0, 14, 0, 0, 0, 2, 1, 17
"/home/williamglass/inventory-app-front-end/src/index.js", "JavaScript", 0, 11, 0, 0, 0, 3, 2, 16
"/home/williamglass/inventory-app-front-end/src/registerServiceWorker.js", "JavaScript", 0, 79, 0, 0, 0, 28, 11, 118
"/home/williamglass/inventory-app-front-end/src/styles/App.css", "CSS", 0, 0, 0, 0, 97, 17, 19, 133
"/home/williamglass/inventory-app-front-end/src/styles/ErrorBoundary.css", "CSS", 0, 0, 0, 0, 11, 0, 1, 12
"/home/williamglass/inventory-app-front-end/src/styles/Modal.css", "CSS", 0, 0, 0, 0, 212, 22, 32, 266
"/home/williamglass/inventory-app-front-end/src/styles/Table.css", "CSS", 0, 0, 0, 0, 195, 22, 33, 250
"/home/williamglass/inventory-app-front-end/src/styles/ToggleSwitch.css", "CSS", 0, 0, 0, 0, 73, 3, 5, 81
"Total", "-", 36193, 4854, 144, 20, 588, 446, 756, 43001